##......S.......
....####..#.....
..###..#..#..#..
..#G...#.#...#..
..#.#..#.#...#..
..#.#..#.#####..
....#..#.....#..
....#...........
....#....###..#.
....#....#...##.
#####..###....G.